white: lantern, edge, winter
yellow: heart, lantern, forge
pink: moth, heart, secret histories
red: heart, grail, forge
orange: edge, forge, grail
blue: winter, knock, secret histories
black: edge, forge, secret histories
purple: knock, grail, moth
gray: moth, winter, secret histories
brown: moth, grail, edge

strengthen
weaken
reverse
neutralize
absolute
identity
similar
difference
other
split
merge
static
explosion
void

strengthen - forge, heart, edge, -moth (rose) [fire]
weaken - winter, knock, moth, -forge (neville) [water] [air]
reverse - moth, grail, edge, -lantern (ysabet) [water]
neutralize - winter, heart, edge, -secret histories (poppy) [air]
absolute - forge, lantern, secret histories, -knock (cat) [earth]
identity - heart, grail, winter, -lantern (slee) [earth]
similar - secret histories 2, heart, -edge (natalia) [water]
difference - moth, edge, knock, -grail (porter) [water]
other - lantern, secret histories, -grail (sulochana) [air]
split - edge, knock, lantern, -heart (sylvia) [fire]
merge - grail, heart, forge, -edge (clovette) [earth]
static - winter 3, -moth (auclair) [earth]
explosion - forge, edge, knock, -winter (clifton) [fire]
void - winter, edge, knock, -grail (enid) [air] [fire]
	
